25
######
#P L##
#NA#L#
## ###
#GA###
######